NO ./src/north.png
SO ./src/south.png
WE ./src/west.png
EA ./src/east.png
F 74,35,1
C 242,191,145


111111
100101
101001
1100N1
111111